{"en": "115", "de": "115", "fr": "115"}
{"en": "131", "de": "131", "fr": "131"}
{"en": "192", "de": "192", "fr": "192"}
{"en": "181", "de": "181", "fr": "181"}
{"en": "109", "de": "109", "fr": "109"}
{"en": "124", "de": "124", "fr": "124"}
{"en": "143", "de": "143", "fr": "143"}
{"en": "123", "de": "123", "fr": "123"}
{"en": "187", "de": "187", "fr": "187"}
{"en": "237", "de": "237", "fr": "237"}
{"en": "228", "de": "228", "fr": "228"}
{"en": "120", "de": "120", "fr": "120"}
{"en": "81", "de": "81", "fr": "81"}
{"en": "101", "de": "101", "fr": "101"}
{"en": "59", "de": "59", "fr": "59"}
{"en": "145", "de": "145", "fr": "145"}
{"en": "94", "de": "94", "fr": "94"}
{"en": "91", "de": "91", "fr": "91"}
{"en": "167", "de": "167", "fr": "167"}
{"en": "194", "de": "194", "fr": "194"}
{"en": "111", "de": "111", "fr": "111"}
{"en": "122", "de": "122", "fr": "122"}
{"en": "104", "de": "104", "fr": "104"}
{"en": "74", "de": "74", "fr": "74"}
{"en": "98", "de": "98", "fr": "98"}
{"en": "118", "de": "118", "fr": "118"}
{"en": "84", "de": "84", "fr": "84"}
{"en": "124", "de": "124", "fr": "124"}
{"en": "88", "de": "88", "fr": "88"}
{"en": "102", "de": "102", "fr": "102"}
{"en": "74", "de": "74", "fr": "74"}
{"en": "89", "de": "89", "fr": "89"}
{"en": "87", "de": "87", "fr": "87"}
{"en": "95", "de": "95", "fr": "95"}
{"en": "107", "de": "107", "fr": "107"}
{"en": "96", "de": "96", "fr": "96"}
{"en": "83", "de": "83", "fr": "83"}
{"en": "112", "de": "112", "fr": "112"}
{"en": "1271", "de": "1271", "fr": "1271"}
{"en": "1753", "de": "1753", "fr": "1753"}
{"en": "1205", "de": "1205", "fr": "1205"}
{"en": "2125", "de": "2125", "fr": "2125"}
{"en": "696", "de": "696", "fr": "696"}
{"en": "1217", "de": "1217", "fr": "1217"}
{"en": "1620", "de": "1620", "fr": "1620"}
{"en": "1724", "de": "1724", "fr": "1724"}
{"en": "1935", "de": "1935", "fr": "1935"}
{"en": "1756", "de": "1756", "fr": "1756"}
{"en": "1133", "de": "1133", "fr": "1133"}
{"en": "2098", "de": "2098", "fr": "2098"}
{"en": "486", "de": "486", "fr": "486"}
{"en": "596", "de": "596", "fr": "596"}
{"en": "574", "de": "574", "fr": "574"}
{"en": "568", "de": "568", "fr": "568"}
{"en": "520", "de": "520", "fr": "520"}
{"en": "529", "de": "529", "fr": "529"}
{"en": "584", "de": "584", "fr": "584"}
{"en": "582", "de": "582", "fr": "582"}
{"en": "577", "de": "577", "fr": "577"}
{"en": "584", "de": "584", "fr": "584"}
{"en": "596", "de": "596", "fr": "596"}
{"en": "520", "de": "520", "fr": "520"}
{"en": "599", "de": "599", "fr": "599"}
{"en": "603", "de": "603", "fr": "603"}
{"en": "530", "de": "530", "fr": "530"}
{"en": "527", "de": "527", "fr": "527"}
{"en": "580", "de": "580", "fr": "580"}
{"en": "573", "de": "573", "fr": "573"}
